wwwwwwwwwwwww
w..3gw......w
w..www......w
w...2.......w
w.......wwwww
w.......w+..w
w...w...w...w
wA..w...1...w
wwwwwwwwwwwww
