wwwwwwwwwwwww
w.2.........w
w.....1.....w
w...w...w...w
w+..w.A.w..gw
w...w...w...w
w.....1.....w
w3........2.w
wwwwwwwwwwwww
