wwwwwwwwwwwww
wA.......w..w
w..w........w
w...w...w.+ww
www.w1..wwwww
w.......w.g.w
w..2........w
w.......2...w
wwwwwwwwwwwww