wwwwwwwwwwwww
w..3.ww....Aw
w....w......w
w.w..1..wwwww
w+w.........w
w.w..wwwwwwww
w.......w...w
w...2w....wgw
wwwwwwwwwwwww
