wwwwwwwwwwwww
w.........g.w
w.......wwwww
w...........w
w.....+.....w
w..wwwwwww..w
w...........w
w.....A.....w
wwwwwwwwwwwww
