wwwwwwwwwwwww
w...........w
w.....A.....w
w..w.....w..w
w.....g.....w
w....www....w
w...........w
w3........+.w
wwwwwwwwwwwww
