wwwwwwwwwwwww
w....1.....gw
w....w......w
w.w.w.......w
w+w....1....w
ww...2....3.w
w..w..w.w.w.w
w...A.......w
wwwwwwwwwwwww
