wwwwwwwwwwwww
w....w....g.w
w...www.....w
w...3www1...w
w..wwwwwww..w
w......w....w
w....w....2.w
wA...w+.....w
wwwwwwwwwwwww
