wwwwwwwwwwwww
w..2......A.w
w...........w
w+..........w
w...........w
w.....1.....w
w...........w
w.....g.....w
wwwwwwwwwwwww
